7
10
~100 ~100 ~100 ~100 V254 V254 R000 ~100 ~100 ~100 
~100 ~100 ~100 ~100 ~100 ~100 ~100 ~100 ~100 ~100 
~100 ~100 ~100 ~100 ~100 ~100 &100 ~100 ~100 ~100 
~100 X234 X234 ~100 ~100 ~100 #100 #100 ~100 ~100 
~100 ~100 ~100 ~100 ~100 ~100 ~100 ~100 ~100 ~100 
G404 ~100 ~100 ~100 ~100 ~100 $000 ~100 ~100 ~100 
#100 #100 #100 #100 #100 #100 #100 #100 #100 #100 