7
3
#100 #100 #100 
~100 ~100 ~100 
~100 ~100 ~100 
~100 ~100 ~100 
~100 #100 ~100 
~100 $000 ~100 
~100 ~100 ~100  