5
7
~100 ~100 G606 ~100 R000 ~100 ~100 
~100 ~100 ~100 ~100 ~100 ~100 ~100 
~100 ~100 ~100 ~100 ~100 ~100 ~100 
$000 ~100 ~100 @206 ~100 ~100 ~100 
#100 #100 #100 #100 #100 #100 #100 