5
7
#100 #100 #100 #100 #100 #100 #100 
$000 ~100 ~100 @106 ~100 ~100 ~100 
~100 ~100 ~100 ~100 ~100 ~100 ~100 
~100 ~100 ~100 ~100 ~100 ~100 ~100 
~100 ~100 G606 ~100 ~100 ~100 ~100 