16
20
#100 $000 #100 #100 #100 #100 #100 #100 #100 #100 #100 #100 #100 #100 #100 #100 #100 #100 #100 #100 
#100 ~100 ~100 ~100 ~100 ~100 ~100 ~100 ~100 ~100 ~100 ~100 ~100 ~100 ~100 ~100 #100 ~100 ~100 #100 
#100 ~100 ~100 ~100 ~100 ~100 ~100 ~100 ~100 ~100 ~100 ~100 ~100 ~100 ~100 ~100 #100 ~100 ~100 #100 
#100 ~100 ~100 ~100 ~100 ~100 ~100 ~100 ~100 ~100 ~100 R000 ~100 ~100 ~100 ~100 #100 ~100 ~100 #100 
#100 ~100 ~100 ~100 ~100 ~100 ~100 ~100 ~100 ~100 ~100 #100 #100 ~100 ~100 ~100 #100 ~100 ~100 #100 
#100 ~100 ~100 ~100 ~100 ~100 #100 #100 #100 ~100 ~100 ~100 ~100 ~100 ~100 ~100 #100 ~100 ~100 #100 
#100 #201 #201 ~100 ~100 ~100 #100 ~100 ~100 ~100 ~100 ~100 ~100 ~100 ~100 ~100 #100 ~100 ~100 #100 
#100 ~100 ~100 #201 ~100 G101 #100 ~100 ~100 ~100 ~100 ~100 ~100 ~100 ~100 ~100 #201 #201 #201 #100 
#100 ~100 ~100 ~100 #201 #100 #100 G505 ~100 ~100 ~100 ~100 ~100 ~100 ~100 ~100 #201 ~100 ~100 #100 
#100 ~100 ~100 ~100 ~100 #100 #100 #100 #100 ~100 ~100 ~100 ~100 ~100 ~100 ~100 #201 ~100 D120 #100 
#100 #100 #100 #100 #100 #100 #100 ^201 ^201 ^201 ^201 ^201 ^201 ^201 ^201 ^201 #100 #100 #100 #100 
~100 ~100 ~100 ~100 ~100 ~100 #100 ~100 ~100 ~100 ~100 ~100 ~100 #205 #205 #205 #100 ~100 ~100 ~100 
~100 ~100 ~100 ~100 ~100 ~100 #100 ~100 ~100 ~100 ~100 ~100 #205 ~100 ~100 ~100 #100 ~100 ~100 ~100 
~100 ~100 ~100 ~100 ~100 ~100 #100 #205 #205 #205 #205 #205 ~100 ~100 ~100 ~100 #100 ~100 ~100 ~100 
~100 ~100 ~100 ~100 ~100 ~100 #100 ^100 ^100 ^100 ^100 ^100 ^100 ^100 ^100 ^100 #100 ~100 ~100 ~100 
~100 ~100 ~100 ~100 ~100 ~100 #100 #100 #100 #100 #100 #100 #100 #100 #100 #100 #100 ~100 ~100 ~100 