5
5
$000 ~100 ~100 R000 G101 
#100 ~100 ~100 ~100 ~100 
#100 #100 ^201 ~100 ~100 
#100 #100 #100 ~100 *000 
#100 #100 #100 #100 #100 