7
10
~100 ~100 ~100 ~100 ~100 V254 R000 ~100 ~100 ~100 
~100 ~100 ~100 ~100 ~100 ~100 ~100 ~100 ~100 ~100 
~100 ~100 ~100 ~100 ~100 ~100 &104 ~100 ~100 ~100 
~100 X224 X224 ~100 V130 ~100 #100 #100 ~100 ~100 
~100 ~100 ~100 ~100 ~100 ~100 ~100 ~100 ~100 ~100 
G404 ~100 ~100 ~100 ~100 ~100 $000 ~100 ~100 ~100 
#100 #100 =100 =100 =100 =100 #100 #100 #100 #100 