5
5
#100 #100 #100 #100 #100 
#100 #100 #100 ~100 ~100 
#100 #100 ~100 ~100 ~100 
#100 ~100 ~100 ~100 ~100 
$000 ~100 ~100 ~100 ~100 