5
5
#100 #100 #100 #100 #100 
$000 ~100 ~100 #201 ~100 
~100 ~100 ~100 #201 ~100 
~100 ~100 G101 ~100 ~100 
~100 ~100 ~100 ~100 ~100 