9
26
~100 ~100 ~100 ~100 ~100 ~100 ~100 ~100 ~100 ~100 ~100 ~100 ~100 ~100 ~100 ~100 ~100 ~100 ~100 ~100 ~100 ~100 ~100 ~100 ~100 #100 
#100 ~100 ~100 ~100 ~100 ~100 ~100 ~100 ~100 ~100 ~100 ~100 ~100 ~100 ~100 ~100 ~100 ~100 ~100 ~100 ~100 ~100 ~100 ~100 ~100 #100 
#100 ~100 ~100 ~100 ~100 ~100 ~100 ~100 ~100 ~100 ~100 ~100 ~100 ~100 ~100 ~100 ~100 ~100 ~100 ~100 ~100 ~100 ~100 ~100 ~100 #100 
#100 ~100 ~100 ~100 ~100 ~100 ~100 ~100 ~100 ~100 ~100 ~100 ~100 ~100 ~100 ~100 ~100 ~100 ~100 ~100 ~100 ~100 ~100 ~100 ~100 #100 
#100 D120 ~100 ~100 ~100 ~100 ~100 ~100 ~100 ~100 ~100 ~100 ~100 ~100 ~100 ~100 ~100 ~100 ~100 G202 ~100 @202 &102 ~100 ~100 #100 
#100 #100 #100 #100 #100 ~100 ~100 ~100 ~100 ~100 ~100 ~100 ~100 ~100 ~100 ~100 ~100 #100 #100 #100 #100 #100 #100 ~100 ~100 #100 
~100 ~100 ~100 ~100 #100 ~100 ~100 ~100 ~100 ~100 ~100 ~100 ~100 ~100 #100 ~100 ~100 ~100 ~100 ~100 ~100 ~100 ~100 ~100 ~100 #100 
~100 ~100 ~100 ~100 #100 ~100 ~100 ~100 $000 ~100 ~100 ~100 ~100 #100 #100 #100 ~100 ~100 ~100 ~100 ~100 ~100 ~100 ~100 ~100 #100 
~100 ~100 ~100 ~100 #100 #100 #100 #100 #100 #100 #100 #100 #100 #100 #100 #100 #100 #100 #100 #100 #100 #100 #100 #100 #100 #100 
