7
3
#100 #100 #100 
~100 ~100 ~100 
~100 -115 ~100 
~100 ~100 ~100 
~100 #100 ~100 
R000 $000 G505 
~100 ~100 ~100  