17
14
#100 $000 #100 #100 #100 #100 #100 #100 #100 #100 #100 #100 #100 #100 
#100 ~100 #100 ~100 ~100 ~100 ~100 ~100 ~100 ~100 ~100 ~100 D120 #100 
#100 ~100 #100 ~100 ~100 ~100 ~100 ~100 ~100 ~100 ~100 ~100 #205 #100 
#100 ~100 #100 ~100 ~100 ~100 ~100 ~100 ~100 ~100 ~100 G505 ~100 #100 
#100 ~100 #100 ~100 ~100 ~100 ~100 ~100 ~100 =100 =100 =100 ~100 #100 
#100 ~100 #100 ~100 ~100 X120X100 X120X100 ~100 f220 ~100 ~100 #100 ~100 #100 
#100 ~100 #100 X120X100 ~100 ~100 ~100 f220 ~100 ~100 ~100 #100 ~100 #100 
#100 ~100 #100 *000 ~100 ~100 ~100 ~100 ~100 ~100 ~100 #100 ~100 #100 
#100 ~100 #100 #100 #100 ~100 ~100 ~100 ~100 ~100 ~100 #100 ^100 #100 
#100 ~100 #100 ~100 ~100 ~100 ~100 ~100 ~100 ~100 ~100 ~100 #100 #100 
#100 ~100 #100 ~100 ~100 ~100 -114 ~100 ~100 ~100 ~100 ~100 ~100 #100 
#100 ~100 #100 ~100 ~100 ~100 w124 ~100 ~100 G404 ~100 ~100 ~100 #100 
#100 ~100 #100 ~100 ~100 #204 #204 #204 #204 ~100 ~100 ~100 ~100 #100 
#100 ~100 #100 ~100 ~100 ~100 ~100 ~100 ~100 ~100 ~100 V130V100 V130V100 #100 
#100 ~100 #100 ~100 ~100 ~100 ~100 ~100 ~100 ~100 ~100 ~100 ~100 #100 
#100 ~100 ~100 ~100 ~100 ~100 ~100 ~100 ~100 ~100 ~100 ~100 ~100 #100 
#100 #100 #100 #100 #100 #100 #100 #100 #100 #100 #100 #100 #100 #100 
