50
50
#100 ~100 ~100 ~100 ~100 ~100 ~100 ~100 ~100 ~100 ~100 ~100 ~100 ~100 ~100 ~100 ~100 ~100 ~100 ~100 ~100 ~100 ~100 ~100 ~100 ~100 ~100 ~100 ~100 ~100 ~100 ~100 ~100 ~100 ~100 ~100 ~100 ~100 ~100 ~100 ~100 ~100 ~100 ~100 ~100 ~100 ~100 ~100 ~100 #100 
#100 $000 G101 ~100 ~100 ~100 ~100 ~100 ~100 ~100 ~100 ~100 ~100 ~100 ~100 ~100 ~100 ~100 ~100 ~100 ~100 ~100 ~100 ~100 ~100 ~100 ~100 ~100 ~100 ~100 ~100 ~100 ~100 ~100 ~100 ~100 ~100 ~100 ~100 ~100 ~100 ~100 ~100 ~100 ~100 ~100 ~100 ~100 ~100 #100 
#100 G101 G101 ~100 ~100 ~100 ~100 ~100 ~100 ~100 ~100 ~100 ~100 ~100 ~100 ~100 ~100 ~100 ~100 ~100 ~100 ~100 ~100 ~100 ~100 ~100 ~100 ~100 ~100 ~100 ~100 ~100 ~100 ~100 ~100 ~100 ~100 ~100 ~100 ~100 ~100 ~100 ~100 ~100 ~100 G202 ~100 ~100 ~100 #100 
#100 ~100 ~100 ~100 ~100 ~100 ~100 ~100 ~100 ~100 ~100 ^201 ^201 ^201 ^201 ~100 ~100 ~100 ~100 ~100 ~100 ^201 ^201 ^201 ^201 ~100 ~100 ~100 ~100 ~100 ~100 ~100 ~100 ~100 ~100 ~100 ~100 ~100 ~100 ~100 ~100 ~100 ~100 ~100 ~100 G202 ~100 R000 R000 #100 
#100 #201 #201 #201 #201 #201 #201 #201 #201 #201 #201 #201 #201 #201 #201 #201 #201 #201 #201 #201 #201 #201 #201 #201 #201 #201 #201 #201 #201 #201 #201 #201 #201 #201 #201 #201 #201 #201 #201 #201 #201 #201 #201 #201 #201 #201 #201 #201 #201 #100 
#100 ~100 ~100 ~100 ~100 ~100 ~100 ~100 ~100 ~100 ~100 ~100 ~100 ~100 ~100 ~100 ~100 ~100 ~100 ~100 ~100 ~100 ~100 ~100 ~100 ~100 ~100 ~100 ~100 ~100 ~100 ~100 ~100 ~100 ~100 ~100 ~100 ~100 ~100 ~100 ~100 ~100 ~100 ~100 ~100 G202 G202 G202 G202 #100 
#100 ~100 ~100 ~100 ~100 ~100 ~100 ~100 ~100 ~100 ~100 ~100 ~100 ~100 ~100 ~100 ~100 ~100 ~100 ~100 ~100 ~100 ~100 ~100 ~100 ~100 ~100 ~100 ~100 ~100 ~100 ~100 ~100 ~100 ~100 ~100 ~100 ~100 ~100 ~100 ~100 ~100 ~100 ~100 ~100 ~100 ~100 ~100 ~100 #100 
#100 ~100 *000 ~100 ~100 ~100 ~100 ~100 ~100 ~100 ~100 ~100 ~100 ~100 ~100 ~100 ~100 ~100 ~100 ~100 ~100 ~100 ~100 ~100 @202 @202 ~100 ~100 ~100 ~100 ~100 ~100 ~100 ~100 ~100 ~100 ~100 ~100 ~100 ~100 ~100 ~100 ~100 ~100 ~100 ~100 ~100 ~100 ~100 #100 
#100 ~100 *000 G303 G303 ~100 ~100 ~100 ~100 ~100 ~100 ~100 ~100 ~100 ~100 ~100 ~100 ~100 ~100 ~100 ~100 ~100 ~100 ~100 @202 @202 @202 ~100 ~100 ~100 ~100 ~100 ~100 ~100 ~100 ~100 ~100 ~100 ~100 ~100 ~100 ~100 ~100 ~100 ~100 ~100 ~100 ~100 ~100 #100 
#100 R000 *000 G303 G303 ~100 ~100 ~100 ~100 ~100 ~100 ~100 ~100 ^202 ^202 ~100 ~100 ~100 ~100 ~100 ~100 ~100 ~100 ~100 @202 @202 @202 @202 ~100 ~100 ~100 ~100 ~100 ~100 ~100 ~100 ~100 ~100 ~100 ~100 ~100 ~100 ~100 ~100 *000 *000 *000 *000 *000 #100 
#100 #202 #202 #202 #202 #202 #202 #202 #202 #202 #202 #202 #202 #202 #202 #202 #202 #202 #202 ~100 ~100 ~100 ~100 ~100 #202 #202 #202 #202 #202 #202 #202 #202 #202 #202 #202 #202 #202 #202 #202 #202 #202 #202 #202 #202 #202 #202 #202 #202 #202 #100 
#100 G303 G303 G303 G303 G303 G303 #203 ~100 ~100 ~100 ~100 ~100 ~100 ~100 ~100 ~100 ~100 #202 ~100 ~100 ~100 ~100 ~100 #202 ~100 ~100 ~100 ~100 ~100 ~100 ~100 G606 ~100 ~100 ~100 ~100 ~100 ~100 #206 ~100 ~100 ~100 ~100 ~100 ~100 ~100 ~100 ~100 #100 
#100 ~100 ~100 ~100 ~100 ~100 ~100 #203 ~100 ~100 ~100 ~100 ~100 ~100 ~100 ~100 ~100 ~100 #202 ^202 ^202 ^202 ^202 ^202 #202 ~100 ~100 ~100 ~100 ~100 ~100 ~100 G606 ~100 ~100 ~100 ~100 ~100 ~100 #206 ~100 ~100 ~100 ~100 ~100 ~100 ~100 ~100 ~100 #100 
#100 ~100 ~100 ~100 ~100 ~100 ~100 #203 ~100 ~100 ~100 ~100 ~100 ~100 ~100 ~100 ~100 ~100 #202 #202 #202 #202 #202 #202 #202 ~100 ~100 ~100 ~100 ~100 ~100 ~100 G606 ~100 ~100 ~100 ~100 ~100 ~100 #206 ~100 ~100 ~100 ~100 ~100 ~100 ~100 ~100 ~100 #100 
#100 ^203 ^203 ~100 ~100 ~100 ~100 #203 ~100 ~100 ~100 ~100 ~100 ~100 ~100 ~100 ~100 ~100 ~100 ~100 ~100 ~100 ~100 ~100 ~100 ~100 ~100 ~100 ~100 ~100 ~100 *000 G606 ~100 ~100 ~100 ~100 ~100 ~100 #206 ~100 ~100 ~100 ~100 ~100 ~100 ~100 ~100 ~100 #100 
#100 ~100 ~100 ~100 ~100 ~100 ~100 #203 ~100 ~100 ~100 ~100 ~100 ~100 ~100 ~100 ~100 ~100 ~100 ~100 ~100 ~100 ~100 ~100 ~100 ~100 ~100 ~100 ~100 ~100 ~100 #205 ~100 ~100 ~100 ~100 ~100 ~100 ~100 #206 ~100 ~100 ~100 ~100 ~100 ~100 ~100 ~100 ~100 #100 
#100 ~100 ~100 ~100 ~100 ~100 ~100 #203 ~100 ~100 ~100 ~100 ~100 ~100 ~100 ~100 ~100 ~100 ~100 ~100 ~100 ~100 ~100 ~100 ~100 ~100 ~100 ~100 ~100 ~100 #205 ~100 ~100 ~100 ~100 ~100 ~100 ~100 ~100 #206 ~100 ~100 ~100 ~100 ~100 ~100 ~100 ~100 ~100 #100 
#100 ~100 ~100 ~100 ^203 ^203 ^203 #203 ~100 ~100 ~100 ~100 ~100 ~100 ~100 ~100 ~100 ~100 ~100 ~100 ~100 ~100 ~100 ~100 ~100 ~100 ~100 ~100 ~100 #205 ~100 ~100 ~100 ~100 ~100 ~100 ~100 ~100 ~100 #206 ~100 ~100 ~100 ~100 ~100 ~100 ~100 ~100 ~100 #100 
#100 ~100 ~100 ~100 ~100 ~100 ~100 #203 ~100 ~100 ~100 ~100 ~100 ~100 ~100 ~100 ~100 ~100 ~100 ~100 ~100 ~100 ~100 ~100 ~100 ~100 ~100 ~100 #205 ~100 ~100 ~100 ~100 ~100 ~100 ~100 ~100 ~100 ~100 #206 ~100 ~100 ~100 ~100 ~100 ~100 ~100 ~100 ~100 #100 
#100 ~100 ~100 ~100 ~100 ~100 ~100 #203 ~100 ~100 ~100 ~100 ~100 ~100 ~100 ~100 ~100 ~100 ~100 ~100 ~100 ~100 ~100 ~100 ~100 ~100 ~100 #205 ~100 ~100 ~100 ~100 ~100 ~100 ~100 ~100 ~100 ~100 ~100 #206 ~100 ~100 ~100 ~100 ~100 ~100 ~100 ~100 ~100 #100 
#100 ^203 ~100 ~100 ~100 ~100 ~100 #203 ~100 ~100 ~100 ~100 ~100 ~100 ~100 ~100 ~100 ~100 ~100 ~100 ~100 ~100 ~100 ~100 ~100 ~100 #205 ~100 ~100 ~100 ~100 ~100 ~100 ~100 ~100 ~100 ~100 ~100 ~100 #206 ~100 ~100 ~100 ~100 ~100 ~100 ~100 ~100 ~100 #100 
#100 ~100 ~100 ~100 ~100 ~100 ~100 #203 ~100 ~100 ~100 ~100 ~100 ~100 ~100 ~100 ~100 ~100 ~100 ~100 ~100 ~100 ~100 ~100 ~100 #205 ~100 ~100 ~100 ~100 ~100 ~100 ~100 ~100 ~100 ~100 ~100 ~100 ~100 #206 ~100 ~100 ~100 ~100 ~100 ~100 ~100 ~100 ~100 #100 
#100 ~100 ~100 ~100 ~100 ~100 ~100 #203 ~100 ~100 ~100 ~100 ~100 ~100 ~100 ~100 ~100 ~100 #204 #204 #204 #204 ~100 ~100 #205 #204 ~100 ~100 ~100 ~100 ^100 ~100 ~100 ~100 ~100 ^100 ~100 ~100 #206 #206 ~100 ~100 ~100 ~100 ~100 ~100 ~100 ~100 ~100 #100 
#100 ~100 ~100 ~100 ~100 ^203 ^203 #203 ~100 ~100 ~100 ~100 ~100 ~100 ~100 ~100 ~100 #204 #204 ~100 ~100 ~100 ~100 #205 ~100 #204 #206 #206 #206 #206 #206 #206 #206 #206 #206 #206 #206 #206 #206 #206 ~100 ~100 ~100 ~100 ~100 ~100 ~100 ~100 ~100 #100 
#100 ~100 ~100 ~100 ~100 ~100 ~100 #203 ~100 ~100 ~100 ~100 ~100 ~100 ~100 ~100 #204 #204 ~100 ~100 ~100 ~100 #205 ~100 ~100 #204 ~100 ~100 ~100 ~100 ~100 ~100 ~100 ~100 ~100 ~100 ~100 ~100 ~100 ~100 ~100 ~100 ~100 ~100 ~100 ~100 ~100 ~100 ~100 #100 
#100 ~100 ~100 ~100 ~100 ~100 ~100 #203 ~100 ~100 ~100 ~100 ~100 ~100 ~100 #204 #204 ~100 ~100 ~100 ~100 #204 #204 #204 #204 #204 ~100 ~100 ~100 ~100 ~100 ~100 ~100 ~100 ~100 ~100 ~100 ~100 ~100 ~100 ~100 ~100 ~100 ~100 ~100 ~100 ~100 ~100 ~100 #100 
#100 R000 R000 R000 R000 R000 R000 #203 ~100 ~100 ~100 ~100 ~100 ~100 #204 #204 ~100 ~100 ~100 ~100 #204 ~100 ~100 ~100 ~100 ~100 ~100 ~100 ~100 ~100 ~100 ~100 ~100 ~100 ~100 ~100 ~100 ~100 ~100 ~100 ~100 ~100 ~100 ~100 ~100 ~100 ~100 ~100 ~100 #100 
#100 #203 #203 #203 #203 #203 #203 #203 ~100 ~100 ~100 ~100 ~100 #204 #204 ~100 ~100 ~100 ~100 #204 ~100 ~100 ~100 ~100 ~100 ~100 ~100 ~100 ~100 ~100 ~100 ~100 ~100 ~100 ~100 ~100 ~100 ~100 ~100 ~100 ~100 ~100 ~100 ~100 ~100 ~100 ~100 ~100 ~100 #100 
#100 G404 G404 G404 G404 G404 G404 G404 ~100 ~100 ~100 ~100 #204 #204 ~100 ~100 ~100 ~100 #204 ~100 ~100 ~100 ~100 ~100 ~100 ~100 ~100 ~100 ~100 ~100 ~100 ~100 ~100 ~100 ~100 ~100 ~100 ~100 ~100 ~100 ~100 ~100 ~100 ~100 ~100 ~100 ~100 ~100 ~100 #100 
#100 ~100 ~100 ~100 ~100 ~100 ~100 ~100 ~100 ~100 ~100 #204 #204 ~100 ~100 ~100 ~100 #204 ~100 ~100 ~100 ~100 ~100 ~100 ~100 ~100 ~100 ~100 ~100 ~100 ~100 ~100 ~100 ~100 ~100 ~100 ~100 ~100 ~100 ~100 ~100 ~100 ~100 ~100 ~100 ~100 ~100 ~100 ~100 #100 
#100 *000 ~100 ~100 ~100 ~100 ~100 ~100 #204 #204 #204 #204 G505 *000 ~100 ^205 #204 ~100 ~100 ~100 ~100 ~100 ~100 ~100 ~100 ~100 ~100 ~100 ~100 ~100 ~100 ~100 ~100 ~100 ~100 ~100 ~100 ~100 ~100 ~100 ~100 ~100 ~100 ~100 ~100 ~100 ~100 ~100 ~100 #100 
#100 *000 *000 ~100 @204 ~100 ~100 ~100 #204 #204 #204 #204 #204 #204 #204 #204 ~100 ~100 ~100 ~100 ~100 ~100 ~100 ~100 ~100 ~100 ~100 ~100 ~100 ~100 ~100 ~100 ~100 ~100 ~100 ~100 ~100 ~100 ~100 ~100 ~100 ~100 ~100 ~100 ~100 ~100 ~100 ~100 ~100 #100 
#100 #204 #204 #204 #204 #204 #204 #204 #204 #204 ~100 ~100 ~100 ~100 ~100 ~100 ~100 ~100 ~100 ~100 ~100 ~100 ~100 ~100 ~100 ~100 ~100 ~100 ~100 ~100 ~100 ~100 ~100 ~100 ~100 ~100 ~100 ~100 ~100 ~100 ~100 ~100 ~100 ~100 ~100 ~100 ~100 ~100 ~100 #100 
#100 ~100 ~100 ~100 ~100 ~100 ~100 ~100 ~100 ~100 ~100 ~100 ~100 ~100 ~100 ~100 ~100 ~100 ~100 ~100 ~100 ~100 ~100 ~100 ~100 ~100 ~100 ~100 ~100 ~100 ~100 ~100 ~100 ~100 ~100 ~100 ~100 ~100 ~100 ~100 ~100 ~100 ~100 ~100 ~100 ~100 ~100 ~100 ~100 #100 
#100 ~100 ~100 ~100 ~100 ~100 ~100 ~100 ~100 ~100 ~100 ~100 ~100 ~100 ~100 ~100 ~100 ~100 ~100 ~100 ~100 ~100 ~100 ~100 ~100 ~100 ~100 ~100 ~100 ~100 ~100 ~100 ~100 ~100 ~100 ~100 ~100 ~100 ~100 ~100 ~100 ~100 ~100 ~100 ~100 ~100 ~100 ~100 ~100 #100 
#100 ~100 ~100 ~100 ~100 ~100 ~100 ~100 ~100 ~100 ~100 ~100 ~100 ~100 ~100 ~100 ~100 ~100 ~100 ~100 ~100 ~100 ~100 ~100 ~100 ~100 ~100 ~100 ~100 ~100 ~100 ~100 ~100 ~100 ~100 ~100 ~100 ~100 ~100 ~100 ~100 ~100 ~100 ~100 ~100 ~100 ~100 ~100 ~100 #100 
#100 ~100 ~100 ~100 ~100 ~100 ~100 ~100 ~100 ~100 ~100 ~100 ~100 ~100 ~100 ~100 ~100 ~100 ~100 ~100 ~100 ~100 ~100 ~100 ~100 ~100 ~100 ~100 ~100 ~100 ~100 ~100 ~100 ~100 ~100 ~100 ~100 ~100 ~100 ~100 ~100 ~100 ~100 ~100 ~100 ~100 ~100 ~100 ~100 #100 
#100 ~100 ~100 ~100 ~100 ~100 ~100 ~100 ~100 ~100 ~100 ~100 ~100 ~100 ~100 ~100 ~100 ~100 ~100 ~100 ~100 ~100 ~100 ~100 ~100 ~100 ~100 ~100 ~100 ~100 ~100 ~100 ~100 ~100 ~100 ~100 ~100 ~100 ~100 ~100 ~100 ~100 ~100 ~100 ~100 ~100 ~100 ~100 ~100 #100 
#100 ~100 ~100 ~100 ~100 ~100 ~100 ~100 ~100 ~100 ~100 ~100 ~100 ~100 ~100 ~100 ~100 ~100 ~100 ~100 ~100 ~100 ~100 ~100 ~100 ~100 ~100 ~100 ~100 ~100 ~100 ~100 ~100 ~100 ~100 ~100 ~100 ~100 ~100 ~100 ~100 ~100 ~100 ~100 ~100 ~100 ~100 ~100 ~100 #100 
#100 ~100 ~100 ~100 ~100 ~100 ~100 ~100 ~100 ~100 ~100 ~100 ~100 ~100 ~100 ~100 ~100 ~100 ~100 ~100 ~100 ~100 ~100 ~100 ~100 ~100 ~100 ~100 ~100 ~100 ~100 ~100 ~100 ~100 ~100 ~100 ~100 ~100 ~100 ~100 ~100 ~100 ~100 ~100 ~100 ~100 ~100 ~100 ~100 #100 
#100 ~100 ~100 ~100 ~100 ~100 ~100 ~100 ~100 ~100 ~100 ~100 ~100 ~100 ~100 ~100 ~100 ~100 ~100 ~100 ~100 ~100 ~100 ~100 ~100 ~100 ~100 ~100 ~100 ~100 ~100 ~100 ~100 ~100 ~100 ~100 ~100 ~100 ~100 ~100 ~100 ~100 ~100 ~100 ~100 ~100 ~100 ~100 ~100 #100 
#100 ~100 ~100 ~100 ~100 ~100 ~100 ~100 ~100 ~100 ~100 ~100 ~100 ~100 ~100 ~100 ~100 ~100 ~100 ~100 ~100 ~100 ~100 ~100 ~100 ~100 ~100 ~100 ~100 ~100 ~100 ~100 ~100 ~100 ~100 ~100 ~100 ~100 ~100 ~100 ~100 ~100 ~100 ~100 ~100 ~100 ~100 ~100 ~100 #100 
#100 ~100 ~100 ~100 ~100 ~100 ~100 ~100 ~100 ~100 ~100 ~100 ~100 ~100 ~100 ~100 ~100 ~100 ~100 ~100 ~100 ~100 ~100 ~100 ~100 ~100 ~100 ~100 ~100 ~100 ~100 ~100 ~100 ~100 ~100 ~100 ~100 ~100 ~100 ~100 ~100 ~100 ~100 ~100 ~100 ~100 ~100 ~100 ~100 #100 
#100 ~100 ~100 ~100 ~100 ~100 ~100 ~100 ~100 ~100 ~100 ~100 ~100 ~100 ~100 ~100 ~100 ~100 ~100 ~100 ~100 ~100 ~100 ~100 ~100 ~100 ~100 ~100 ~100 ~100 ~100 ~100 ~100 ~100 ~100 ~100 ~100 ~100 ~100 ~100 ~100 ~100 ~100 ~100 ~100 ~100 ~100 ~100 ~100 #100 
#100 ~100 ~100 ~100 ~100 ~100 ~100 ~100 ~100 ~100 ~100 ~100 ~100 ~100 ~100 ~100 ~100 ~100 ~100 ~100 ~100 ~100 ~100 ~100 ~100 ~100 ~100 ~100 ~100 ~100 ~100 ~100 ~100 ~100 ~100 ~100 ~100 ~100 ~100 ~100 ~100 ~100 ~100 ~100 ~100 ~100 ~100 ~100 ~100 #100 
#100 ~100 ~100 ~100 ~100 ~100 ~100 ~100 ~100 ~100 ~100 ~100 ~100 ~100 ~100 ~100 ~100 ~100 ~100 ~100 ~100 ~100 ~100 ~100 ~100 ~100 ~100 ~100 ~100 ~100 ~100 ~100 ~100 ~100 ~100 ~100 ~100 ~100 ~100 ~100 ~100 ~100 ~100 ~100 ~100 ~100 ~100 ~100 ~100 #100 
#100 ~100 ~100 ~100 ~100 ~100 ~100 ~100 ~100 ~100 ~100 ~100 ~100 ~100 ~100 ~100 ~100 ~100 ~100 ~100 ~100 ~100 ~100 ~100 ~100 ~100 ~100 ~100 ~100 ~100 ~100 ~100 ~100 ~100 ~100 ~100 ~100 ~100 ~100 ~100 ~100 ~100 ~100 ~100 ~100 ~100 ~100 ~100 ~100 #100 
#100 ~100 ~100 ~100 ~100 ~100 ~100 ~100 ~100 ~100 ~100 ~100 ~100 ~100 ~100 ~100 ~100 ~100 ~100 ~100 ~100 ~100 ~100 ~100 ~100 ~100 ~100 ~100 ~100 ~100 ~100 ~100 ~100 ~100 ~100 ~100 ~100 ~100 ~100 ~100 ~100 ~100 ~100 ~100 ~100 ~100 ~100 ~100 ~100 #100 
#100 ~100 ~100 ~100 ~100 ~100 ~100 ~100 ~100 ~100 ~100 ~100 ~100 ~100 ~100 ~100 ~100 ~100 ~100 ~100 ~100 ~100 ~100 ~100 ~100 ~100 ~100 ~100 ~100 ~100 ~100 ~100 ~100 ~100 ~100 ~100 ~100 ~100 ~100 ~100 ~100 ~100 ~100 ~100 ~100 ~100 ~100 ~100 ~100 #100 
#100 #100 #100 #100 #100 #100 #100 #100 #100 #100 #100 #100 #100 #100 #100 #100 #100 #100 #100 #100 #100 #100 #100 #100 #100 #100 #100 #100 #100 #100 #100 #100 #100 #100 #100 #100 #100 #100 #100 #100 #100 #100 #100 #100 #100 #100 #100 #100 #100 #100 
